###############
#.##.....#....#
#.######.#.##.#
#.#....#...##.#
#.#.##.######.#
#.#.##.#......#
#.#.##.#.###.##
#.#.##.#.###..#
#.####.######.#
#.............#
#.####.######.#
#.####..#...#.#
#.#.###.#.###.#
#@#.....#.....#
#s#############
