###############
#....#.....##.#
#.##.#.######.#
#.##...#....#.#
#.######.##.#.#
w@.....#.##.#.#
##.###.#.##.#.#
#..###.#.##.#.#
#.######.####.#
#.............#
#.######.####.#
#.#...#..####.#
#.###.#.###.#.#
#.....#@....#.#
###############