###############
#....#.....##.#
#.##.#.######.#
#.##...#....#.#
#.######.##.#.#
#......#.##.#.#
##.###.#.##.#.#
#..###.#.##.#.#
#.######.####.#
#.............0
#.######.####.#
#.#...#..####.#
#.###.#.###.#.#
#.....#@....#.#
###############
