#.#############
#.#............
#.###########.#
#.............#
###############
#.....#.#.....#
#.#####.#####.#
#......@......#
#.#..##.###.#.#
#.##.##########
#.##.#........#
#..#.#.######.#
####.#.#.......
#......#.##.#.#
#.###########.#