#.#############
#.#.#...#...#..
#.#.#.#.#.#.#.#
#.#...#...#...#
#.#.###########
#.#.#..........
#.#.#.#######.#
#.#.#.#.....#.#
#.#.#.#####...#
#.#.#.....#####
#.#.#####.#...#
#.#.......#.#.#
#.#.#######.#.#
#...........#..
###############