###############
...............
########.######
..######.#....#
#.######.#..#.#
#......#.####.#
#.######......#
..#......######
.##.####.#....#
....#..#.#..#.#
###.#..#.####.#
#.............#
########.######
..#...........#
#.######.######