#....#...#...##
#.###.###.###.#
#.#.........#.#
#.#.#####.#.#.#
#.#.#.....#.#.#
#.#.###.###.#.#
#.............#
#############.#
#.............#
#.#############
#.............#
#############.#
#...#...#...#.#
#.#...#...#...#
#.#############