#.###########.#
............#..
######.####.###
#......#..#....
##.#####..#####
...............
##.##.#########
#...#.........#
#.###########.#
#...#.........#
###.#.#########
#...#..........
#.#############
..............#
###############