#.#############
#..............
#..............
#..............
#..............
#..............
#..............
#..............
#..............
#..............
#..............
#..............
#..............
#..............
###############