###############
..............#
......k.......#
..............#
..............#
..............#
..............#
..............#
..............#
..............#
..............#
..............#
..............#
..............#
..............#