###############
...............
#..............
...............
#..............
#..............
#..............
...............
...............
...............
#..............
#..............
#..............
...............
#..............