#.######.######
.......#.#.....
#.####.#...####
#...#..########
#####.#.......#
#.#.#.#######.#
#....@........#
###.#.#.#######
#.....#.#......
#.....#.#...#.#
#.....#.#####.#
#...###.......#
......#########
#..............
#..............