###.###.###.###
....#.#.#.....#
#####.#.#.....#
........#.....#
....#####.....#
..............#
..............#
..............#
..............#
..............#
..............#
..............#
..............#
..............#
#####s#########