###############
..#.....#......
#....#..#######
#####..........
#...#.#######.#
###.#.......#.#
..#.#######.#.#
#.#..#......#..
#.##.#.#######.
#....#.......#.
#.##########.##
#.#........#..#
#.#.######.#.##
#.#......#...#.
#.#############
