####n##########
#..#.....#.....
##.#####.##.#.#
#......#.##.#.#
#.####.#.##.#.#
#.##.###.##.#.#
#.##.....##.#..
#.##.######.#.#
#.#..#........#
#.#....######.#
#.###..#...##.#
#...####.#.##.#
#.#....#.#.#..#
#.##.#.#.#.#.##
#....#...#...##
