###############
..............#
#.###########.#
#......#......#
######.#.######
#......#......#
#.###########.#
#......#......#
######.#.######
#......#......#
#.###########.#
#.#....#....#.#
#.#.#.##.####.#
#...#.#.......#
#####.#########