###.###########
....#..........
#########.#####
...#..........#
####.###.####.#
.........#....#
##########.####
#........#.#...
#.######.#.####
#......#.#....#
######.#.####.#
.....#.#......#
######.########
#............K#
###############