###.###.###.###
....#.#.#.#.#.#
#####.#.#.#.#.#
#.......#.#.#.#
#.#######.#.#.#
#...........#.#
####.######.#.#
.....#...#....#
####.#.#.######
#....#.#.#....#
#.######.#.##.#
#......#.#..#.#
#.######.####.#
#.....#.......#
#####2#########