#.#############
..#.#...#...#.#
#.#.#.#.#.#.#.#
..#...#...#...#
#.#.###########
..#.#.........#
#.#.#.#######.#
#.#.#.#.....#.#
#.#.#.#####...#
#.#.#.....#####
#.#.#####.#...#
..#.......#.#.#
#.#.#######.#.#
#...........#.#
###############