#.###########.#
............#..
######.####.###
#......#..#....
##.#####..#####
#..............
##.##.#########
....#.........#
#.###########.#
#...#.........#
###.#.#########
#...#..........
#.#############
#.............#
#############s#