###############
...#.....#K...#
##.#####.##.#.#
.......#.##.#.#
#.####.#.##.#.#
#.##.###.##.#.#
#.##.....##.#.#
..##.######.#.#
..#..#........#
..#....######.#
#.###..#...##.#
#...####.#.##.#
#.#....#.#.#..#
..##.#.#.#.#.##
#....#...#...##
