##############
#K.#..........
#.............
#.............
#.............
#.............
#.............
#.............
#.............
#.............
#.............
#.............
#.............
#.............
#.............