#######.#######
#...#..........
#.###########.#
#.#.........#.#
#.#.#######.#.#
#.###.......#.#
#...#.#######.#
###.#.##....#.#
#.#.#.##.####.#
#.#...##......#
#.######.######
#...#......#..#
###.#.####.##..
#...#...#.....#
###.###.###.###