###############
#.............#
#.##.########.#
#.##.#....#.#.#
#..#.#.##.#.#.#
#..#.#..#.#...#
#..#.#..#.#.###
#..#.#.k#.#....
#..#.####.#.###
#..#......#...#
#..##########.#
#.#.........#.#
#.##..#.#..##.#
#.....#.#.....#
#######.#######