###############
#.#.....#......
#....#..#######
#####..........
#...#.#######.#
..#.#.......#.#
#.#.#######.#.#
#.#..#......#..
#.##.#.#######.
.....#.......#.
#.##########.##
#.#........#..#
#.#.######.#.##
#.#......#...#.
#.#############
