##############
.#######.....#
.......#.#.#..
##.#.#.###.###
.###.#...#...#
...#.###.###.#
##.#...#......
#..#.#.#######
#....#........
######.#######
.#...#.#.....#
##.#.#.#.###.#
##.#.#.#.#.#.#
#..#.....#....
#.############