#.#############
..#............
#.###########.#
#.............#
#########.#####
......#.#.....#
#.#####.#####.#
#......@......#
#.#..##.###.#.#
..##.##########
#.##.#........#
#..#.#.######.#
####.#.#.......
.......#.##.#.#
#.###########.#