###.###########
....#.........#
#####.#######.#
#...#.#........
###.#.#########
#.....#.......#
#.###.#.#####.#
#...#.#.....#..
###.#.#######.#
#...#.........#
#.#############
#.#...#...#....
#.#.#.#.#.#.#.#
....#...#...#.#
###############