#.###########.#
#.#...#........
#...#...#####.#
..#######.....#
#.#.###.#.#####
#.#.#m#.#.....#
#.#.###.#####.#
..#..#..#.....#
#.#.##..#.#####
#.#..#..#.....#
#.#.##..#####.#
..#.....#.....#
#.#######.#####
#..............
###############