###############
#K###.#.#...#..
#...#.#.#.#....
###.#.#...#####
#.#.#.#.###.#..
#.#...#........
#.#.#.##.######
#....##..#...##
#.#.##..#..#.##
#.#.......#####
###.#######....
#.....#...#.###
####.##.#.#.###
#.......#...###
###############