###############
.#######.....##
.......#.#.#...
##.#.#.###.####
.###.#...#...##
...#.###.###.##
##.#...#.......
#..#.#.########
#....#.........
######.########
.#...#.#.....##
##.#.#.#.###.##
##.#.#.#.#.#.##
#..#.....#.....
#.#############