##########.####
#...#....#....#
#.#.#.##.#.####
..#...#..#....#
#####.#######.#
#........#....#
########.#.####
.........#....#
#############.#
#.............#
######.########
..#.....#.....#
#.##.########.#
#.............#
###############