###############
#.#....#.......
#.####.#.######
#......#.#...##
#.##.....#.#.##
#.#.##.###.#...
#.#.#...#..#.##
#.#...#....#.##
#.#.#...#..####
#...##.######..
#.#.........###
#.#....####..##
#.####.#.#.#.##
#......#.......
###############