###.###.####.##
....#...#.#####
#####.#.#.....#
#.....#.#.###.#
#.##.##.###...#
#.#.........###
#.#.######.##.e
###......####.4
..######.#....#
#.#......#.####
#.#.######....#
#.#......####.#
#.######.#....#
.........#.####
##########.####