###############
#.#...#...#...#
#.#.#.#.#.#.#.#
#...#...#...#..
######.########
#k#.......#...#
#.#.#.#.#.#.#.#
#.#.#.#.#.#.#..
#.#.#.#.#.#.#.#
#...#...#...#.#
######.########
#...#...#...#..
#.#.#.#.#.#.#.#
#.#...#...#...#
###############