###############
###...#......##
..#.#.#.####.##
#.###.#.#..#.##
#...#.#.#..#.##
###.#.#.#.##.##
..#.#.#.#......
#.#.#.#.#######
..#.....#....##
######.###.#.##
#...#..#...#.##
#.#...##.#.#.##
#.#####..#.#.##
........###....
#.#######.#####