###############
#.....######..#
#.###........##
#...########.##
#.#.#.........#
#.#.#.#########
..#.#.........#
###.#########.#
#...#......#..#
#.#...#.####.##
#.#######.#..##
#.......#...###
#####.#.#.###.#
....#.#.#.....#
###.###.####.##