##############
#K###.#.#...#.
#...#.#.#.#...
###.#.#...####
#.#.#.#.###.#.
#.#...#.......
#.#.#.##.#####
#....##..#...#
#.#.##..#..#.#
#.#.......####
###.#######...
#.....#...#.##
####.##.#.#.##
#.......#...##
#.###.########