#####.#########
....#.........#
#.###########.#
#.#.........#.#
#.#.#######.#.#
#.###.......#.#
#...#.#######.#
###.#.##....#.#
..#.#.##.####.#
#.#...##......#
#.######.######
#...#......#..#
###.#.####.##.#
....#...#.....#
###.###.###.###