#.#############
..#............
#.###########.#
#.............#
###############
#.....#.#.....#
#.#####.#####.#
#......@......#
..#..##.###.#.#
#.##.##########
#.##.#........#
#..#.#.######.#
####.#.#.......
.......#.##.#.#
#.###########.#