###############
#.#...........#
#.#.#########.#
#....#........#
#.####.########
#.#........#...
#.######.#.#.##
.........#...##
###############
#......#...#...
#..###.#.#.#.##
##...#...#....#
##.#.########.#
#..#........#.#
####.######.###