###.###.###.###
#...#.#.#.#.#..
#####.#.#.#.#.#
#.......#.#.#..
#.#######.#.#.#
#...........#..
####.######.#.#
#....#...#....#
####.#.#.######
#....#.#.#....#
#.######.#.##.#
#......#.#..#..
#.######.####.#
#.....#.......#
#####2#########