#.#######.#####
........#......
#.####.##..####
#...#..########
#####.#.......#
#.#.#.#######.#
#....@........#
###.#.#.#######
#...#.#.#......
#####.#.#...#.#
#.#...#.#####.#
#.#.###.......#
..#.#.#########
###............
###.###########